C 25,8,255 
F 25,100,255

NO ./assets/textures/a.png
SO ./assets/textures/b.png
WE ./assets/textures/c.png
EA ./assets/textures/d.png


1111111111111111111111111
1000000000000000000000001
10000000000N0000000000001
1001000000000000000000001
1000000000110000001100001
1000000000000000000000001
1111111111111111111111111