F 25,100,255
C 25,8,0

NO ./assets/textures/a.png
SO ./assets/textures/b.png
WE ./assets/textures/c.png
EA ./assets/textures/d.png

1111111111111111111111111
1000000000000000011100001
10011100000N0000000000001
1000000000000000000000001
10000000011110000000000011111111111
10000100000000000000100000000000001
10000000000000000000000000000000001
1110011111111111111111111111111111
111001
1111001
11111001
11111001
111110001
1111100001111111111111111111111111
10000011000000000000000000000000001
100000000000000000000000000000000001
1000000000000000000000000000000000001
1111100000000000000000000000000000001
111111111111111111111111111111111111
