F 25,100,255
C 25,8,0

NO ./assets/textures/a.png
SO ./assets/textures/b.png
WE ./assets/textures/c.png
EA ./assets/textures/d.png

1111111111111111111111111
1000000000000000011100001
10011100000N0000000000001
1000000000000000000000001
1000000001111000000000001
1000010000000000000010001
1111111111111111111111111